nuc	prot
ATGATGTTTAAATCGGTTTGCGAGATACGAGGAAGCTAG	MMFKSVCEIRGS*
ATGTTGGTATTGGACCTAGCTTTGTGACCCATGTGGCCACCTACGGCCAGACTTTAG	MLVLDLAL*PMWPPTARL *
ATGAGAACCAGTACAACAAAATGGCTAATATTTGCTTGAACTCGTAATAGCGACTAA	MRTSTTKWLIFA*TRNSD*
ATGGATTATAGTGAAAAACCAAGTTTGCTCCCTGCTTAGAATCGGAAGTAA	MDYSEKPSLLPA*NRK*
ATGACCCCTCTTCTTAATCAATGCGAGGATCATGAGTAATGACAGTATACGGTCTGCTAA	MTPL L NQCEDHE**QYTVC*
ATGGTCTTCCGGGTATCCTTTTGTTGA	MVFRVSFC*
ATGCCAGTATGCAACGAAGGGAGTCCCGGCGCATCCGCGGCGAATCAGTAGCTCCTTATACATCCCCTTTTCCACAGCGCGTAGTGCTGA	MPVCNEGSPGASAANQ*LL IHPL FHSA*C*
ATGATCGATCGGGATCGCGAAACTGGAGTTCTTGACATTATTTCCGCAGGTCGTGCGGTGCCGTGGTCCGATGAACGCTGA	MIDRDRETGVL DIISAGRAVPWSDER*
ATGTTACTCGGTAACAGTAATTTATAGCATTTAAAATCGCCATAA	MLLGNSNL*HLKSP*
ATGCTTTTGTTTTCCGGCGACAACTACTTTGCGTAG	ML LFSGDNYFA*
ATGTGAGGACGTCCTTTCGGTGCTTATGTTACGTGAAACTACCAGTACTGCCAGGCCTCTCTGGCGTCCCCGTTGCCTTCGTGA	M*GRPFGAYVT*NYQYCQASLASPLPS*
ATGATGGTAGCTACGAGTCTTCTGAGCTTTGACTGA	MMVATSL LSFD*
ATGTTAAGATCGCTTCTCGGTGAGTGTGGGTTTCATATGTAA	MLRSL LGECGFHM*
ATGAAATGGTTCTGTTTATGACCGGTAGCGCAACCGCTTTCCGTAGACTACGTTAAGCACCCTTTGTGCTCGTACTAATTGTAAGGGCGATAG	MKWFCL*PVAQPL SVDYVKHPLCSY*L*GR*
ATGATCTGGCTTTGACTTGTGCTACTAATCAGCACCGTCACCCTCAGCGAAGGCGGCGTACGAGGTGAGGGATAA	MIWL *L VLLISTVTLSEGGVRGEG*
ATGAGGGAATCCGGCCCGATAGGATGACATCGAACAAGCTACATTCCAACTCACGAGCTGTGTCGCGACTTGGGCTAA	MRESGPIG*HRTSYIPTHELCRDLG*
ATGTATATCAGAGGTAATAGAGTGCCAGCTTAGCATATGTAGTTGAGCCGCAAGCATTAA	MYIRGNRVPA*HM*LSRKH*
ATGTGTCGCGTGGCGGCAAGGTAGTTCTCCCAGAAGACTTCTGTTCGTGATCATCGGGCCTACTCTCACAATCTGCTAAATATCTTATTACAACACATGTGA	MCRVAAR*FSQKTSVRDHRAYSHNLLNILLQHM*
ATGAGCTTTTGTTTTCGCCAGTCACGTGAAATTGCTTCCTGA	MSFCFRQSREIAS*
ATGCAGTTAAGCACCGGCGGCGTGTGGTTATGAGAAGGATATATCACGCTGGCCAGCGGGAGCTCCGCCCCGAGTTAA	MQLSTGGVWL*EGYITLASGSSAPS*
ATGAGATAACTAGTATACCTCACCTTTGCTGCCATAATCCGTAACTTCACTTTCCCTGACTAATTGTACGGATACTAGTTCTGA	MR*LVYLTFAAIIRNFTFPD*LYGY*F*
ATGGACCGGCCGCGCTTCGTCGTCCTAGTATACTCTAAGTACAGCTGGCGTTGTTGTATCCCTGGCGCGACAAGAATCGGGTTTGACGATCGAGGAGGCTAA	MDRPRFVVLVYSKYSWRCCIPGATRIGFDDRGG*
ATGACACTAAGCTACTTGCCTCAAAAATCACATCACATTTAAAACTACTAG	MTLSYLPQKSHHI*NY*
ATGTCTTACTGCACATTAAACGCCCCAAGGTCAGAGGAAGGATGCTAGTCCGATATTCGTTGCCTAACTAGATGATGATGA	MSYCTLNAPRSEEGC*SDIRCLTR***
ATGTCTTGAAACCTTCAGTTGGCCTAGCTCCCGCCCTATTGTAATGGAAAGGACAAATTGCATTAA	MS*NL QLA*LPPYCNGKDKLH*
ATGTGTGCCTTTTTCTATAAGAATGTATAG	MCAFFYKNV*
ATGTGCCAAGTACACCACTTCTGCCCTCTCGGAGGCTCGGGGCGGGGGTATTAA	MCQVHHFCPLGGSGRGY*
ATGGAGCGTACACCATCTCAGAATTGGTTCTGGTTCCGCTTGCATCTTGGCGTCCTAGCGGTGCTTTTTGGCCCTTAG	MERTPSQNWFWFRLHL GVLAVL FGP*
ATGAATTCCACCGGCGGTTAACTGGACCTAAAATGA	MNSTGG*LDLK*
ATGTTCTAGCAGAGGTCATGCGAAGCCAAAAACGCACGGTAA	MF*QRSCEAKNAR*
ATGAGTCTTCACCCGAGCTCTATGCGGAGAGAACTCGGACGCGCCCCTCAATCGAATTGAGATAGTTGGTGTTTGCCTATAGAACCCTAG	MSL HPSSMRRELGRAPQSN*DSWCLPIEP*
ATGACATCCTGCCAGAAACATACTTACTAAATAAGCAGGTTTGACCAGTAG	MTSCQKHTY*ISRFDQ*
ATGTGGGCTGCGGACACCCATCCGAACGCCGTATCTGCCTCAAGCCTACCCGCAGCCTTCCTGAGAATCTGATAGCTATAG	MWAADTHPNAVSASSLPAAFLRI**L*
ATGTCCTAAGTTTCCCTCATATTGAGGGTCGTAGAGGTCTAG	MS*VSLILRVVEV*
ATGAGTACGCCATAATCCGGCTAGATCTGTTTTCTATACCTACCCCAATGATTACTTCTAGAGAACCGAGGGATGTTCGAGCAATGTCGGAAGTAG	MSTP*SG*ICFLYLPQ*LL LENRGMFEQCRK*
ATGGTTTGACGACTGTTTCTTGCCGCGGTATAAACAGTCTGTCCCTACTCACAGAATTCAATGATTACTTAG	MV*RLFL AAV*TVCPYSQNSMIT*
ATGTAGGCGGTCTCAGTGAATTTTTGCTGTCTCGGATTACTATCTATGAATAAAGTTGTCTAA	M*AVSVNFCCLGLLSMNKVV*
ATGCTGATAGCGAGATCAGTACACGATAAGTAGGGTACCCTTGGTACGTCTAGTTAA	MLIARSVHDK*GTL GTSS*
ATGTTTTCTTCTTGAGCTCCGTGTAGTCAGCCTAGTGTCCACCGACGAACGTGA	MFSS*APCSQPSVHRRT*
ATGGCTGCCACACACAATCATCGGAGCGTACCCACGACAGTTTTCAATAGATACCACCTCATTATGCACTTAGTATGAAAAAATGTCCCTGACACTCTATAA	MAATHNHRSVPTTVFNRYHLIMHLV*KNVPDTL*
ATGATCAATATTAGACAAAGCCGGTAA	MINIRQSR*
ATGTGTCCCCACTGCCAGGCTTTCCGCACTGAAAAAACGGCTACGAAGTAA	MCPHCQAFRTEKTATK*
ATGTGAATTAGAGAACTTGAGAAAGGCCAGCAACCGATGAATCGCCGCGGGCGTTGTAAGACTTGCTGATAAATAGGGTTATCCGGTCCCATGTGGTAG	M*IREL EKGQQPMNRRGRCKTC**IGLSGPMW*
ATGTACTTACGTCCGTAATCTCCGGTCCCATAG	MYLRP*SPVP*
ATGCGCTACCGGGTTAGCAGCGCACGTTGCTAGCGTATAGTTCTTTACTAGCAGACCGCTAATTCGTGA	MRYRVSSARC*RIVL Y*QTANS*
ATGGTCGGCTCCGCCCCGACCCACAGGGAAATGCTTAGAGCTGGTTAA	MVGSAPTHREML RAG*
ATGCACCCAGCCGACACCAATTGCACTTTCGTGGTCATAGGAAGTCTCGCTCGCGACTAA	MHPADTNCTFVVIGSLARD*
ATGTCCAGGAGGGAACCCGGTGCGCTCCTCGCACCAAAAAGGTAA	MSRREPGALLAPKR*
ATGTATCTATGGAACAAGGATACCCTGCAGTCCTGGGTCGGGACTTAGGGCTGAGGTCTGTCAGCAACTATGCTGACGTCATGGGATGTAGACGGGCTAAACTGA	MYLWNKDTLQSWVGT*G*GLSATMLTSWDVDGLN*
ATGGCTCAACGGGGTACTGGGACCAAACATACGCTGGGCTTAGTTTAG	MAQRGTGTKHTLGLV*
ATGTTGGGGACAGATTGTAGTGTCATTCGCTAG	MLGTDCSVIR*
ATGAAACTCCCCTGATGTACCCAAGTGCTGTGACTTCACCCCTAG	MKLP*CTQVL*L HP*
ATGGAGCTCCATTTTAGGGGTATATAATCAAAGGAGACTAGTTTTGTTTAGCTGTTTGTTCTACACCATGCCTGA	MELHFRGI*SKETSFV*LFVLHHA*
ATGAACGACTAAAAACAAGTTATATAAATGCTGATCCTGGATTGATATAATAACCCGGCACGATTCGCAGGCCCGACGGGGTTCCACTAAAAGGAGAAGATCTAA	MND*KQVI*MLILD*YNNPARFAGPTGFH*KEKI*
ATGCGAAGACCCGGTTTTATTAGGGAAGGGCGCAGAGCCTAA	MRRPGFIREGRRA*
ATGGGAGTGCAAGTTCTTCAGTGTGAGGCCGTGTATATCCGTGGGAGTGCAAAAGTCATCTCCCGGCGACAACAGGATTCGACGAGTTAA	MGVQVL QCEAVYIRGSAKVISRRQQDSTS*
ATGTGGAAGGGTCTCTGCTCAATAATGTCAGCGGCCTCTAAGGCCTTAAACAATTAGAAACGAGCGTAG	MWKGLCSIMSAASKALNN*KRA*
ATGCCCATCCATTGTAGTTAGGACTGTCTACTCGATTAA	MPIHCS*DCLLD*
ATGGTGGGCAACTTGGGATGCAATCAAGTTTACAGAAGATCTATCAGATCGTGA	MVGNLGCNQVYRRSIRS*
ATGAACAGACGAGCCCGGGACCTATACGTTTGGTAA	MNRRARDLYVW*
ATGGGCTTGAGGGGCGATCATGCGAGCGAAATAGTAGGCGGTACGAATAAGCGGGGCAACGTTTAAAATGACTTCCTATCCAAATAA	MGLRGDHASEIVGGTNKRGNV*NDFLSK*
ATGGTTAGATCGAACGTTAAATTTGCCTAA	MVRSNVKFA*
ATGCCCACACTGTGGTCAACATTGCCTACCTCATTTTCCCAGCGCTGCGCGACCAGGTGCTTGATGCATCTTATCACTTAGCTCTCGGTGGAATAG	MPTLWSTLPTSFSQRCATRCLMHL IT*LSVE*
ATGACAGAACTTAACGTTTTGCAAAGCTGCGGGCGCAAAAATGACCCTTACGAATCGGCACTACTCGTTGATCTCCCAGTTCAAATCTAA	MTEL NVLQSCGRKNDPYESALLVDLPVQI*
ATGGTTTCGACAGTTCCCTATTACAGTATTATGGTCTTCCCATTTTTAACAGAACGACAACCGTCTTCCGTCGATACCTAACTCTCGTAA	MVSTVPYYSIMVFPFLTERQPSSVDT*LS*
ATGGGTCAACTCGGAGTGCAGACTTAGATCTGACTTGCATGA	MGQLGVQT*I*L A*
ATGAAAGCAGAATAAGCCGTATATCACCCGCTTAAAACCCTTGGCTGACACCCTTCACGGTGTGTGGGAAGATGGTTTTTCACTGTTCGGGTTTTTCTAGTGTGA	MKAE*AVYHPL KTL G*HPSRCVGRWFFTVRVFLV*
ATGTCATCCTCTCGTTTTAAAGAGTCCGCCGATCACGCAGCCCTCGGGATGTGTCTATTCCCAGCTTCCCAAGTCTGATAG	MSSSRFKESADHAALGMCLFPASQV**
ATGCATCATACATTCGTTTTCAACAGTGGTCATCCACATTGTGCAGGCGCCCGATAGAAAGGCACATCATCAATGCTCTACGTCTCGGCTGATTAA	MHHTFVFNSGHPHCAGAR*KGTSSMLYVSAD*
ATGCCTAGTGAGCCATTCCTGTGGAGGGTGTTCAAAAAGAAATGA	MPSEPFLWRVFKKK*
ATGATTGGGATGTGATGTCCCCACACGAGGATGAGCATACAATCAGAGAACCCTGCGTAAAACAGACAGTGGTCGTTACCTTCATCTCGCGCTGCGTGA	MIGM*CPHTRMSIQSENPA*NRQWSLPSSRAA*
ATGATCCGCATTACGCTGTACTGCATGACAGGCACAATAGACCTGGGCTTATGTACTATACTTGATCACATTTCATGCTGGACCCGTCTTACTTACATCTGCTAA	MIRITLYCMTGTIDLGLCTIL DHISCWTRL TYIC*
ATGAAATACATCTAGTACCAAGATGCCCACAGGGAATTGTCCCTCCGCAACACGCTAAACCCAATGTAG	MKYI*YQDAHRELSLRNTLNPM*
ATGTTTGCGGCGCGTAAATCCAGGCGGACATGGCCTGATGAACGAGTTGAGATGATCCCAACTTAG	MFAARKSRRTWPDERVEMIPT*
ATGGTCGTGTTTTTCGCCAAAGGAAGGCCGCACCCCTTATCTACAATCAAGTTGGTTGCATAG	MVVFFAKGRPHPLSTIKLVA*
ATGGGTGGGGGGTCCGCACTTTCTCCGAGATAA	MGGGSAL SPR*
ATGATATACATTGGAAGCGCACCAAAGGCAGGAGGCGCGTGTTTCTTGGCCTCCAGATAA	MIYIGSAPKAGGACFLASR*
ATGTATTAAGTGGCACTACAATTTGATCGTGACGTGACATGGCGGATTAGAGCCAACAGACCAGTGTCACGTCGTGTTGAGACCGCCTAA	MY*VALQFDRDVTWRIRANRPVSRRVETA*
ATGTTGCGCCGAACGCTAAATTCAATCGGATCATCGTATCCGAAGTCCAAAAGACTCTGGACGCCCACTAGCATCTCAGGTATCAGATTTTCAGCCTAG	MLRRTLNSIGSSYPKSKRLWTPTSISGIRFSA*
ATGCAGATATAAAGTGCCCAGGGTCAAGGGAGGCTATCTATTTGAATTACCGGAATTTAAAACTAG	MQI*SAQGQGRLSI*ITGI*N*
ATGCCGATTGTTGCTGAGGAAACTTGA	MPIVAEET*
ATGGATATTCTGCATTGCGGTCGAGTATACAATCTTGAACATCGTTCCTAAGTCATTCTTTAGCTCCGGGAGCGACAAAGGTGA	MDILHCGRVYNL EHRS*VIL *LRERQR*
ATGGACCGGACTCCTTACTAGGGATACAGGATAACTTGCTCGTTACCCTTTACTGCTAGCAAGGTACCAGACTGACTCTAG	MDRTPY*GYRITCSLPFTASKVPD*L*
ATGTCGGGAGGCGTTGAGGGTACACCCCAGACCCGTGCTCTCAGAAAATTTGAGCCAACTTTCTAGTGTTAG	MSGGVEGTPQTRALRKFEPTF*C*
ATGCATGTCTGAAAACGTTCAGGCACACATGGGCAAAGTTCATAG	MHV*KRSGTHGQSS*
ATGCGATAGCTCGTTTCACACCGACTAGCGGTCTAGATCATCGAGAACTAG	MR*LVSHRLAV*IIEN*
ATGAACACCGAGTCACACTCCACATTTAGACAGTGCTAG	MNTESHSTFRQC*
ATGTGTACTTAATGTGGACAGTATTAG	MCT*CGQY*
ATGGAGACGGATTTCGACAGCGGGTCCAACTAGATGCGACGTAGCCTGTAA	METDFDSGSN*MRRSL*
ATGCTGGTTACACCTATTAGTGGTTCTACCGTAATATAA	MLVTPISGSTVI*
ATGCACCGCGTTTCCACATATAAATTTATACAAGCAGATATGGGTTGAATCACTCGTTGCTCCATCACCAAGATGGGAGGCTCCGCTGCTTTTGCGCCGCGTTAA	MHRVSTYKFIQADMG*ITRCSITKMGGSAAFAPR*
ATGCCTGATTCCTCCAAAATTCGCTGGGCCTTCGATACTGACCCAGAGTGA	MPDSSKIRWAFDTDPE*
ATGGATTACTTTCAGCGAACAGCGTTGAGTGATTTTAAGAAGGAGGCGGAAAGGGGCGGATTTTGGAACTGCCCCGGGCTCAAATAG	MDYFQRTALSDFKKEAERGGFWNCPGLK*
ATGTCTCTTGGTTGCGACCGTACTGCATGGATGCCAAAGGTCCTGGAGAGGCGCTTTCAAGCAGGCTTTCACGTTATGAGCTATACCTATTAG	MSL GCDRTAWMPKVLERRFQAGFHVMSYTY*
ATGGGAGGCACGAGAAGGACAGTGTCATTCACATGTCACTGACTCTGA	MGGTRRTVSFTCH*L*
ATGTCTGTCCGCAAAAACCGAGTGATACATCCGAGGGGGCTGACGGATTGTCTAGTAAGTTAG	MSVRKNRVIHPRGLTDCLVS*
ATGCACAATAGTAGTAGGCTCGTGATGGATTGAGCATATAGTCGAACTGGGTGA	MHNSSRLVMD*AYSRTG*
ATGCGGGGCGATACGTAGACAAGGTAGCACCGGATTAACGAGGCCTCGTTCAATGAATCCAAGACACTTTCCAACCATCACTTATAA	MRGDT*TR*HRINEASFNESKTL SNHHL*
ATGAGGCTATATCCACGATGTGCCGTCTGTCTTAAGCTCTTCCGCATCGAGTAA	MRLYPRCAVCL KLFRIE*
ATGCGCAAAAGATCTCCAAAACCGATAGAGCAACCGCTCTGTGTCAAGTTCAAGGCAACGAGGAACCCGCCCTACCACATCCTTCTGAGCTAA	MRKRSPKPIEQPLCVKFKATRNPPYHIL LS*
